[console_scripts]
analyze-log = edx.analytics.tasks.tools.analyze.main:analyze
debug-emr-logs = edx.analytics.tasks.tools.debug_emr_logs:main
launch-task = edx.analytics.tasks.launchers.local:main
obfuscate-eval = edx.analytics.tasks.tools.obfuscate_eval:main
remote-task = edx.analytics.tasks.launchers.remote:main
s3util = edx.analytics.tasks.tools.s3util:main

[edx.analytics.tasks]
all_events_report = edx.analytics.tasks.monitor.total_events_report:TotalEventsReportWorkflow
answer-dist = edx.analytics.tasks.insights.answer_dist:AnswerDistributionPerCourse
calendar = edx.analytics.tasks.insights.calendar_task:CalendarTableTask
catalog = edx.analytics.tasks.warehouse.course_catalog:CourseCatalogWorkflow
course_blocks = edx.analytics.tasks.insights.course_blocks:CourseBlocksApiDataTask
course_list = edx.analytics.tasks.insights.course_list:CourseListApiDataTask
cybersource = edx.analytics.tasks.warehouse.financial.cybersource:DailyPullFromCybersourceTask
data_obfuscation = edx.analytics.tasks.export.data_obfuscation:ObfuscatedCourseDumpTask
database-import = edx.analytics.tasks.insights.database_imports:ImportAllDatabaseTablesTask
dump-student-module = edx.analytics.tasks.export.database_exports:StudentModulePerCourseTask
ed_services_report = edx.analytics.tasks.warehouse.financial.ed_services_financial_report:BuildEdServicesReportTask
engagement = edx.analytics.tasks.insights.module_engagement:ModuleEngagementDataTask
enrollment_validation = edx.analytics.tasks.monitor.enrollment_validation:CourseEnrollmentValidationTask
enrollments = edx.analytics.tasks.insights.enrollments:ImportEnrollmentsIntoMysql
event-type-dist = edx.analytics.tasks.warehouse.event_type_dist:PushToVerticaEventTypeDistributionTask
events_obfuscation = edx.analytics.tasks.export.events_obfuscation:ObfuscateCourseEventsTask
export-events = edx.analytics.tasks.export.event_exports:EventExportTask
export-events-by-course = edx.analytics.tasks.export.event_exports_by_course:EventExportByCourseTask
export-student-module = edx.analytics.tasks.export.database_exports:StudentModulePerCourseAfterImportWorkflow
financial_reports = edx.analytics.tasks.warehouse.financial.finance_reports:BuildFinancialReportsTask
grade-dist = edx.analytics.tasks.data_api.studentmodule_dist:GradeDistFromSqoopToMySQLWorkflow
insert-into-table = edx.analytics.tasks.common.mysql_load:MysqlInsertTask
load-course-catalog = edx.analytics.tasks.warehouse.load_internal_reporting_course_catalog:PullCourseCatalogAPIData
load-d-certificates = edx.analytics.tasks.warehouse.load_internal_reporting_certificates:LoadInternalReportingCertificatesToWarehouse
load-d-country = edx.analytics.tasks.warehouse.load_internal_reporting_country:LoadInternalReportingCountryToWarehouse
load-d-user = edx.analytics.tasks.warehouse.load_internal_reporting_user:LoadInternalReportingUserToWarehouse
load-d-user-course = edx.analytics.tasks.warehouse.load_internal_reporting_user_course:LoadUserCourseSummary
load-events = edx.analytics.tasks.warehouse.load_internal_reporting_events:TrackingEventRecordDataTask
load-f-user-activity = edx.analytics.tasks.warehouse.load_internal_reporting_user_activity:LoadInternalReportingUserActivityToWarehouse
load-internal-active-users = edx.analytics.tasks.warehouse.load_internal_reporting_active_users:LoadInternalReportingActiveUsersToWarehouse
load-internal-database = edx.analytics.tasks.warehouse.load_internal_reporting_database:ImportMysqlToVerticaTask
load-warehouse = edx.analytics.tasks.warehouse.load_warehouse:LoadWarehouseWorkflow
location-per-course = edx.analytics.tasks.insights.location_per_course:LastCountryOfUser
noop = edx.analytics.tasks.monitor.performance:ParseEventLogPerformanceTask
obfuscation = edx.analytics.tasks.export.obfuscation:ObfuscatedCourseTask
orders = edx.analytics.tasks.warehouse.financial.orders_import:OrderTableTask
overall_events = edx.analytics.tasks.monitor.overall_events:TotalEventsDailyTask
payment_reconcile = edx.analytics.tasks.warehouse.financial.reconcile:ReconcileOrdersAndTransactionsTask
paypal = edx.analytics.tasks.warehouse.financial.paypal:PaypalTransactionsByDayTask
problem_response = edx.analytics.tasks.insights.problem_response:LatestProblemResponseDataTask
push_to_vertica_lms_courseware_link_clicked = edx.analytics.tasks.warehouse.lms_courseware_link_clicked:PushToVerticaLMSCoursewareLinkClickedTask
run-vertica-sql-script = edx.analytics.tasks.warehouse.run_vertica_sql_script:RunVerticaSqlScriptTask
run-vertica-sql-scripts = edx.analytics.tasks.warehouse.run_vertica_sql_scripts:RunVerticaSqlScriptTask
sqoop-import = edx.analytics.tasks.common.sqoop:SqoopImportFromMysql
student_engagement = edx.analytics.tasks.data_api.student_engagement:StudentEngagementTask
tags-dist = edx.analytics.tasks.insights.tags_dist:TagsDistributionPerCourse
user-activity = edx.analytics.tasks.insights.user_activity:CourseActivityWeeklyTask
video = edx.analytics.tasks.insights.video:InsertToMysqlAllVideoTask

[mapreduce.engine]
emu = edx.analytics.tasks.common.mapreduce:EmulatedMapReduceJobRunner
hadoop = edx.analytics.tasks.common.mapreduce:MapReduceJobRunner
local = luigi.hadoop:LocalJobRunner

